222202322
322232223
325333522
223333322
223343322
223333323
223232323
232252222
222212322