533333222522
242242224224
232223222223
222323224325
222303225322
242333222324
522244422213