145422242222423
333333333333323
342225222222323
323333333332323
323524222232323
323233333232343
323232223232323
323532323432323
353232303232353
323232333232323
323234222232323
323233333332323
323224222522343
323333333333323
324222242225223
333333333333333