2222222242222222242222222222225222222222222
2432222222222222222222224222225222222222322
2222222233333332223333332222322222222222222
2222222222532222223142222222322222222222222
2522222222232222223422222222325522224442222
2222225222232222223333322222322222222222222
2222422222232222223222222222322222222222222
2222222230232222223222222222322222222222222
2225222233332222223333332222333333322224522
2422225222222222224422222242222222222522242
2233333333333333333333333333333333333333322