33333313
32252323
22242323
03252223
23343223