33333313
32222323
22222323
03222223
23323223